+-+-+-+-+-+-+-+-+-+-+
|     |     |   |   |
+ +-+ + + +-+ + +-+ +
|   |   |     |   | |
+ + +-+-+-+-+-+-+ + +
| | |       |   |   |
+ + + +-+-+ + +-+-+-+
| | |     | |       |
+ +-+ +-+ + +-+ +-+ +
|   | | | |       | |
+-+ + + + +-+-+-+-+ +
|   | |       |     |
+ +-+ +-+-+-+-+ +-+-+
|     |             |
+-+-+-+-+-+-+-+-+-+-+
