+-+-+-+-+-+-+-+-+-+
|     |           |
+ + +-+ +-+-+-+-+-+
| |   | |         |
+ +-+ + + +-+-+-+ +
| | | |       |   |
+ + + +-+-+-+ + +-+
| | |       | |   |
+ + +-+-+-+ +-+-+ +
|         |       |
+-+-+-+-+-+-+-+-+-+
