+-+-+-+-+-+-+-+-+-+-+-+-+
|               |   |   |
+ +-+-+-+-+-+-+ + + + + +
| |       |   | | |   | |
+ + + +-+ +-+ + +-+-+-+ +
| | |   |     |     |   |
+ + +-+ +-+-+-+-+-+ + +-+
|     |       |   |     |
+-+-+ + + +-+-+ + +-+-+-+
|     | |       |       |
+ + +-+ +-+-+-+-+-+-+-+ +
| |   | |         |   | |
+ +-+-+ + + + +-+-+ + + +
| |     | | | |   | |   |
+ + +-+-+ + +-+ + + +-+-+
| |       |   | |     | |
+ +-+-+-+-+ +-+ +-+-+ + +
|         |   | |   |   |
+-+-+-+ +-+-+ +-+ + +-+-+
| |   | |   |     |     |
+ + + + + +-+-+-+-+-+-+ +
| | |   |     |   |   | |
+ + +-+-+-+ +-+ + + + + +
|         |     |   |   |
+-+-+-+-+-+-+-+-+-+-+-+-+
