+-+-+-+-+-+
|         |
+-+ +-+-+ +
|   |     |
+ +-+ +-+-+
| |       |
+-+ +-+-+ +
|     | | |
+ +-+-+ + +
|       | |
+-+-+-+-+-+
